07 07 07 02 02 02 02 02 02 02 02 02 02 02 02 02 02 02 07 07 07 
07 00 00 00 00 00 00 00 00 00 00 00 00 00 00 00 00 00 00 00 00 
07 00 00 00 00 00 00 00 00 00 00 00 00 00 00 00 00 00 00 00 00 
02 00 00 00 00 00 00 00 00 00 00 00 00 00 00 00 00 00 00 00 00
02 00 00 00 00 00 00 00 00 00 00 00 00 00 00 00 00 00 00 00 00 
02 00 00 00 00 00 00 00 00 00 00 00 00 00 00 00 00 00 00 00 00 
02 00 00 00 00 00 00 00 00 00 00 00 00 00 00 00 00 00 00 00 00 
02 00 00 00 00 00 00 00 00 00 00 00 00 00 00 00 00 00 00 00 00 
02 00 00 00 00 00 00 00 00 00 00 00 00 00 00 00 00 00 00 00 00 
07 00 00 00 00 00 00 00 00 00 00 00 00 00 00 00 00 00 00 00 00 
07 00 00 00 00 00 00 00 00 00 00 00 00 00 00 00 00 00 00 00 00 
